***********
*        G*
*         *
*         *
*         *
*         *
*    S    *
*         *
*         *
*         *
***********
